Абрикос – ква̄кква. Абсурд – мягIнаакква. Авторитет – хIурматла. Агент – вакил.
Айва – ччимите. Активный – сейхузив. Амулет – кIа/гьекал Арба – ӯка.
Аргумент – далил. Аромат – кквягI. Атлас – атIлас.
Бабушка – аттаба /абаба. Баня – хIямям.
Барабан – ттам. Баран – ква.
Бархат – кьвалт. Беда – бала.
Беседа – ихтират. Бок – щале.
Бусы – баче. Бег – дуцI.
Бегать – дуцIулхъий /умдий. Бегом – дуцIле.
Бежать - вимдий /дуцIухъий. Беседовать - ихтиратукIий.
Бесплатно – кIунал. Блестеть – рябцIбукIий.
Близко – акле.
Бедность – мискиндихь. Бездельник – азгъин.
Безопасный – эйххеакквазиб. Безработица – гIячеакквадихь. Безразличный – агвараакквар. Белизна – цIубдихь.
Береза – махъв. Беседа – ихтират.
Беспорядок – хIямпIарас. Бинокль – дурнабе.
Битва – дява, дигъ. Блестеть – рябцIбукIий. Близкий – акзив.
Близко – акле.
Близнецы – хIясан-хIусанте. Блинчики – чегьатIиб тIултIе. Богатство – давла, масс, хазина.
Богатый – давлачибзив / абданзив.
Богатырь – багьадур, нарт, батир.
Бок – шале. Болезнь – иццала. Болеть – ицций. Болото – шилкан.
Больше - гьис, ххя, хвала.
Большой – хвалазиб/ хвалел. Больной – иццузив.
Борода – муцIуй. Бочка – чирма.
Бояться – ӯхкквий. Браслет – кулаха. Бревно – цциххин. Бросать – лакIбидикьий/ихьвий.
Брынза – нисса. Брюки – вачаг. Брюхо – кIултIа. Буква– хIярп.
Буря – бгIурум. Бутылка – шуша. Бык – ус, бугъа. Быстро - видяхиб. Быстрый – гьалакзиб.
В следующем году – гьибадус. В этом году – ейдус.
Важно – бажил. Варенье – мураппа.
Варить – билщий /лущий. Вата – бамба.
Вверх – хъайе, лак, чива. Веревка – дилхан.
Веселый – ццихъзив. Вещь – сикIабха.
Вблизи – акле, щулиб. Вверх – чиб, чилиб.
Вдали – гьихъле.
Весной – абла.
Вечером – дярххя, сяхIярра. Вдаль – гьихъле.
Вдвое – кIвегьатте, кIвийка. Вдова – ккама хьунул.
Вдруг – хабаракквалл. Ведьма – бяжук
Век – дяшдус. Веник – мӯс. Вера – дин.
Верность – мардихь. Вернуть – чарба̄кьий. Вернуться – чарсавхий. Верхом – мӯттал.
Весело – ццихъле. Весна – аб.
Весы – умсан. Ветка – кьяле.
Ветер – хьхьур, щгIур. Вечер – дярххя, сяхIярра. Вещь – сикIабха.
Взгляд – гьар. Вздох – сигь. Взнос – пай.
Взять – гьабалчий. Вид – куц, даража. Видеть – бихккви, тебидилжий.
Вилка – чIала.
Вина – такьсир, гIяяб, багьна. Виноград – тIитIе.
Вкус – тIим. Вкусный – биццизиб. Власть – хIукмят.
Вначале – талабилтал, багьтал, чикьтал, ссибтаал.
Вниз – губа, кат, гуле. Внутри – букквиб.
Внучка – галла (йуссила) йусе. Вода – шин.
Волк – бицI. Волос – гъис. Вольно – азатле. Вообще – бикIле. Вор – хъилигве. Воробей – хъалчIе. Ворона – къгIина. Ворота – къапу.
Воск (пчелиный) – бухъу муучIал.
Воспитать – гьабикьий/ бякъий.
Вспоминать – гьантасабичихъий.
Встать – ахъгьицций /гьицций. Впереди – талаб.
Впоследствии – гьекъил, гьиба.
Встретить, встретиться – тавяхъий/къаршеухвий. Все – сикIал.
Всегда – гьарбе, ттурахъул. Время – замана/ вахт.
Время от времен – уучи-учи, сухъ-сухъ.
Вчера – сса. Выздороветь – араухвий.
Выкройка – бишибиссала.
Высокий – ахъзиб. Вялый – кгIижибзив.
Гадалка – палче. Галька – гъягъяй. Гармонь – чанагъа. Гвоздь – гъгIумул. Где – чинаб.
Где-то – чинабкIабухая. Герой – игит, гъвабза.
Глава – бикI, хвалел. Гладкий – лгIугъгIунзиб. Глаза – улбе.
Глина – бухъу гIянччя. Глотка – кьахха.
Глубина – ццукьдихь. Глубокий – ццукьзиб. Глупец – ахмах, абдал. Глухой – хIунцIа.
Гнев – хIясидихь. Гнездо – миргв. Гнет – зулму.
Гнилой – биибзиб. Говорить – гъайуквий. Год – дус.
Голова – бикI. Голод – ккушдихь.
Голодный – ккушзиб. Голос – тIама.
Голубь – нахьва. Гора – дубур.
Горе – дард, децI
Гореть – икквий. Горец – дубурлан. Горло – кьахха.
Горн – дулган. Город – шагьар.
Горький – кьабкьзиб. Горянка – дубурлан хьунул. Горячий – буцIейзиб.
Гостиная – павла хъал, тавханна.
Гость – ххгIул. Государство – хIукмат.
Готовиться – хIядурвихвий. Гранат – анар.
Грех – мунагь. Гроза – хъябхъя. Гром – къукъу. Грудь – михъай.
Грустный – пашманзив, вакьунзив.
Груша – хъгIи. Губа – кIвинтI. Гусь – къваз.
Грязный – биччязив.
Да – гьу, саб. Давать – билуччий. Давно – талал.
Далеко – гьихъле.
Далекий, дальний – хIихъзив. 
Дар – пишкиш.
Дар - савгъат.
Дар - пагь.
Даргинец – дарккван. Даром – тякле, няхIякь. Два – кIве.
Дважды – кIвигна. Дверь – уцца.
Дворец – ккялгIя. Двоюродный – уццикьай. Девушка – йуссе.
Дедушка – аттата, абатта. Действие – баакьутте, баркьай. Делать – бийкьий.
Дело – къуллукъ. День – бее.
Деньги – āс. Дерево – ттутта. Держать – буси. Десять – вицI. Дети – бикIате. Дешево – дуугьал.
Дешевый – дуугьазиб. Длинный – бухъинзиб. Днем – эйли.
Добро – гIяхдихь. Дом – хъал.
Дома – хъилиб. Домой – хъил. Донос – гIярзба̄кьне. Дорога – хьуне.
Дорогой – 1.дурхъазиб (эбзиб) 2.ихIярзиб.
Дорого, свято – дурхъал, эбле. Досыта – вилкъадаже.
Дочь – йуссе. Дракон – аждагьа.
Дрожать – йуччий Дурной – абдал.
Дым – булкьа, гав. Дыня – хъабазаг. Дыра – ахьа.
Дышать – сигь укIвий.
Животное – жанавар, xlяйван. Жизнь – гIумру.
Жир – гIягъвядихь, мутIадихь. Жить – хIирухи.
Жук – мяхъв.
Еда – буккин. Еж – кьитIкьа. Ежели – йахле. Еле – бара-бара.
Ехать – чикижив ваши. Ещё – салйа, гьибайа. Ж
Жаба – хIитIа. Жадный – кьиркьир. Жажда – мурждихь.
Жалеть – уукIвецIидухъий. Жара – буцIейдихь.
Жареный – бейцIибзиб. Жаркий – буцIезиб.
Жатва – ищне. Жевать – чIямбикьий. Железо – мих.
Желтый – бухъузиб. Жемчуг – игъян.
Жених – ваччиб туб. Женщина – хьунул. Жеребенок – къята. Жестянка – чадиркьван. Ждать – гьекъекижий. Живой – мицIейзиб.
Забава – хIяз. Забор – ххя.
Заболеть – иццанухви. Забыть – хъуметий.
Завет – васият. Завтра – ччавал. Заказ – хъайче.
Закончить – таманбаакьи, ттабидагъи.
Закрытый – бинбукьунзиб, чидакьибзиб.
Заметка – лишан, макьала. Заменить – Баасбаакьи.
Замок – гъулмух. Замолчать – пIяцIвечIи. Замуж – хьад.
Запах – кквягI.
Запись – кабжне, билкI. Зарплата – зарплата.
Засада – викижне. Заснуть – вилсси. Засолить – ццилабакьий. Засуха – дигъва.
Затылок – хъвянтIала. Зашить – баахий.
Заяц – гъвя.
Звать – вявкабечIий. Звезда – ди.
Звонок – занг. Звонить - зангъукIви. Звук – тIама.
Здесь – яниб. Здоровье – арадихь. Здоровый - Аразиб. Зеленый – шяняшзиб. Землетрясение – ккуцциндакьне.
Земля – гванза, гIянччя. Земляника – лада.
Землянка – къуш. Зеркало – ляхIямцIала. Зерно – кьве, ризкье.
Зима – га.
Зимой – ганилла.
Зло – хъямдихь, хIясидихь. Змея – мялгIун.
Знать – булхIи. Зола – ххъвисса. Золото – муте.
Зрелый – бикьибзиб. Зря – нахIякь, тякле. Зуб – сула.
Зять – ккияв.
Игла – бииппа Игра – хIяз.
Идти – ваший.
Избить – вити, верхьвий.
Избранный – чигьакьивзив. Известие – хабар.
Известный – якьинзиб, хабарла.
Извещение – хабар. Извинить – чикейхвий. Измена – бисне, вишвешне. Изменение – тапатдихь.
Изменить – дикIебакьий. Иногда – сухъ-сухъ.
Изредка – сухъ-сухъ, нагагь. Изюм – дегъуб тIитIе.
Имя – зу. Иначе – дикIел.
Индейка – кIуркIур. Иней – шахв.
Инструмент – яракь. Интерес – тамаша. Искать – умцIий.
Искра – цIарха. Испечь – бецIий.
Использовать – дуццихъий. Испортить – зябакьий.
Исправить – балчебакьий. Испугать – ӯхаттагъий.
Исчезнуть – пяхгьицций. Итог – ахир.
Кабан – жакьа.
Каблук – каблук, кьячIа. Каждый – гьарил.
Как – сагъун, сагъунне.
Какой – сезиб, кучил. Как-то – сухъ.
Калека – чулахъ. Камень – къаакъа. Камыш – чIихIя.
Канал – жужай, къанав. Капать – кIатIкабкIий. Капкан – ппав.
Капля – кIатI. Капризный – витIезив. Карандаш – кIалам.
Карман – киса. Картина – сурат. Картофель – картуп. Кастрюля – гIяшак. Кипеть – йуччий.
Кислый – кьацзиб. Кислота – кьанцIа. Клевать – къутIкабкIий. Клевер – гIябкIаппан.
Клеить – бяссий.
Клеймо – нугьру, ттамгъа. Ключ – умхьу.
Кклятва – хъве. Книга – китаб. Кнут – гIучмяк. Ковер – тIамсса. Когда – мӯт.
Когда-то – мӯт-сабил, мӯт-дил. Кожа – кам, кабц, куле.
Козел – къяца. Колесо – уле. Комар – тIуз. Комната – хъал.
Конец – ахир, таман. Контракт – вяхIда, личIаб. Копать – укъий
Копейка – кипик.
Корень – жилгIя, маркъва. Корзина – чIип.
Коричневый – дулкьунзиб. Кормить – баххий.
Корова – кьгIул. Короткий. КутIзиб. Коршун – къиргъа.
Коса – 1. кьаче, 2. КъгIулкъгIу. Коснуться – тавдагъи /качвичи. Кость – лика.
Кот – ччиту. Крапива – миц.
Красивый – бгIукьязиб. Красиво – гIяляматле, бгIукьял.
Краска – ранг. Краснеть - итIингьичи. Красный – итIинзиб.
Краткий – кутIзиб. Крепкий – дибгазиб. Кривой – бялкIунзиб. Кричать – вяв укIий. Кровь – бе.
Кролик – гъвя. Круг – ччур.
крыльцо – хъайццане. Крыса – кьиркква.
Крыша – чIижехъалтала. Куда-то – чина-дил, чина- сабил.
Кузина – йуццикьай. Кукла – нача.
Кукуруза – хIяжлаачIе. Кукушку – ккуккук.
Кулак – кьгIуш.
Купаться – чивацций, чяхухий. Купить – ассий.
Курдюк – гIяшякIум. Курица – гIягIя.
Куропатка – къакъба. Куст – кьвата, гъвила.
Лад – бизидихь.
Ладонь – хъватI, бакв нӓхъ. Лампа – лампа, чагъ.
Лань – хьвинта. Ласковый – малхIямзив. Ласточка – жата.
Лгать – сумкубтад ваший. Лев – арслан.
Левый – хъямил/хъямилнашал. Легенда – хабар.
Легкий – кукзиб. Легко – кукле, саматле. Лед – миг.
Лежать – киссий. Лекарство – дарман. Лён – 1. урбиш (раст.),
2.лен (ткань) душе. Лес – дуцца.
Летать – гIихий. Лето –гьанешши.
Летом – гьанищила. Лечить – гIяхвакьий. Ливень – ряхIмят.
Линия – тугъ, къкъил. Лиса – ккутта.
Лист – кIаппе. Листья – кIапне. Лицо (муж.) – вяй.
Лицо (жен.) – йяй. лицо (жив.3 кл) – бяй. Лица – дяй.
Лоб – натта. Лопата – кIятIа.
Лошадь, конь – ябу, уче. Лужа – шя.
Луна – бац. Луч – нур. Лучше – гIяхле.
Любимый /ая – виккузив / йиккузий.
Любить – виччи /йиччи/биччи/ дичи.
Любовь – дика. Люди – уй, улкка. Лягушка – хIитIа.
Магазин – тукан. Магнит – макьлатIис. Мак – накьранача.
Маленький – бикIазиб. Малина – зиза.
Мало – камле.
Мальчик – галл. Мама – аба.
Манжеты – кIучме.
Масло – митIе, гIягъвядихь. Матрац – буш.
Мачеха – аттала хьунул. Мёд – вада.
Медведь – ссика. Медленно – багьлал. Мелкий – хурдазиб. Мельница – шилкьан. Меньше – камле, кам. Мера – умсла.
Мертвый – бибкIа. Место – мусса.
Месяц – бац. Меха – ссулкка.
Мешать – виттеваххи / бахбаакьи.
Мешок – къап, гьалам. Милосердие – уукIицIе. Милый – ихIярзив.
Мир – дуна, бизидихь. Много – дахъле, ххял. Мокрый – бяссунзиб. Молния – цIалипан.
Молодой – жагьил. Молоко – ниг.
Молоток – кьгIукь. Море – ухьу.
Морковь – житI. Мороз – буххве, дӱъ. Мост – ччиме.
Муж – туб, адаме.
Мужчина – адаме. Мука – нукьун.
Муравей – димдала. Муха – тIатI.
Мыло – ихъан. Мысль – пикре. Мягкий – кIянтIизиб. Мясо – диг.
Мяч – ттимилихъ.
Навес – пурхигула. Навстречу – хьунта. Надежда – умут.
Назло – хъямбакьли. Наизусть – укIвелжиб. Найти – бааччий.
Налево – хъяминнащал. Налог – харж.
Написать – кабжий. Направо – гIяххиннащал. Напрасно – няхIякь, ттякле. Народ – халкь, улкка.
Наследник – букьуй. Начало – бебидихьут. Наш – ниссила.
Небо – ццаб.
Невеста – йаччибхьад, цIиквай. Неделя – ккае.
Нет – юх, уу, акква, либакква. Низкий – гухъзиб.
Невкусный – пяпсиб, тIимъакквазиб.
Некрасивый – биччязиб. Неожиданно – хабаракквалл. Низкий – гухъзиб.
Никак – сечIугъунне. Новинка – цIизиб.
Новость – цIе хабар. Новый – цIизиб.
Нога – тIгIуй. Ноготь – мика. Нож – дис.
Ножницы – лукIва. Нос – къгIухъ.
Носить – бикъкъий. Ночь – дучче.
Ночью – дуччили. Нравиться – гIяхтакабицций. Нужно – бажил да/саб.
Нужный – бажизиб. Ныне – хена, кIена. Нюхать – сунтIгьабикьий.
Оба – кIвиял.
Обед – ирилла, ире. Обеднеть – мискинухвий.
Обезьяна – маймун, мяммялук. Обидеться – читтевидухъий.
Облик – куц, кабиц. Облако – къуажай. Облачно – къугуйле. Обмануть – вибхъий. Обменять – басбаакьий. Обморок – къагъдихь.
Обнять – гъгIучIквевакьий. Обрадоваться – ццихъчегьавхий.
Образец – 1. тяхIяр 2. исла. Образование – билчIутте. Обратно – чарле.
Обряд – гIядат. Обувь – ттаппе.
Объявление – бишкаттагъне. Объяснение – эгъахъне.
Овца – мацца. Огонь – цIа.
Одежда – палтар. Одеть – чеахий. Однажды – сухъ. Одуванчик – аппахъус.
Оживить – мицIебаакьий. Ожидать – гьегъекижий. Озеро – шя.
Окно – уццидигала. Окончание – ахир, таман. Олово – къалай, будай.
Он – ит, ил, икI. Опрос – хьайбагъне. Опять – гьибайа.
Орать – чIярукIвий, вявукIвий. Орел – чIикя.
Оружие – яракь. Осёл – хIямхIя. Осень – ибхьне. Осенью – ибхьнилла. Основа – виб.
Острый – бумкказиб. Остановить – тIашагъий.
Остывший – бяибзиб. Отара – ттурзум.
Отважный – гIяхгъвабза. Ответ – жуваб.
Отдохнуть – вамццалаахъий. Отец – атта.
Отчество – аттала зу. Отечество – ватIан. Отдать – квебиччий. Отдельно – дикIел, тикле, тик-тикле.
Отлично – гьакал гIяхле, гIяляматле.
Открыть – таквбакьий. Открытый – таквзиб. Откуда – чинал.
Отставать – гьилавичий. Отсутствие – акквадихь. Охота – гIяяр.
Охотник – гIяяркья. Оценка – кьимат.
Очередь – ярга. Ошибка – хатIа.
Падать – кабийчий. Падчерица – вий йуссе. Палец – тIуп.
Палка – мяргъя, кIаакI, дехьа. Папа – атта.
Парень – къазахъгал. Пароход – парахуд, гамии. Пастух – дукруш.
Пахнуть – кквягIбукIий. Пачкать – биччяба̄кьий. Певец – далайче.
Пена – хьамхьа, бяркя, хьулхьум.
Перевязать, завязать – бихий, чиббихий.
Переменить – ба̄сбакьий. Песня – далай.
Петь – далайукIвий. Песок – къум.
Печаль – щищим. Печень – дуликI. Писать – кабийжий. Письменность – билкI. Письмо – кIа.
Пить – уччий. Плакать – виссий. Пища – буккин Платье – агва.
Плечо – хъачIала.
Плохой – усалзив, баразив. Плохо – хъямле, барал.
Плыть – шиндикьий. Победа – чеухъне.
Поведение – шикьатIала. Погода – а̄гъ.
Подарить – пишкишбакьий. Подарок – савгъат.
Поддержка – кумак, гьикьала. Поделить – бутIий.
Подлость – усалдихь. Поднос – тIабакI. Поднять – ахъгьабакьий.
Поймать – бусий. Пойти – гIукьий. Поменять – басба̄кьий.
Помогать – кумакба̄кьий. Понты – къугъне Постирать – бийсий.
Подруга – йусбаллайуссе. Подсказать – чибуутий.
Подушка – гIянихьала. Позавчера – ссалитай. Покой – паргъатдихь. Полностью – битунне. Полный – бицIибзиб. Понимать – игъий.
Пополам – кIвебаг. Послезавтра – ччавалакквамутил. Посуда – хатIавахъ. Праздник – байрам. Предмет – сикIабха. Прежний – вибзиб. Прибыль – хейре, пейда. Привет – салам.
Привыкнуть – буссаухвий. Пригласить – вашгьаий.
Приговор – хIукму. Придумать – гьантагьабаччий. Прийти – сякьий.
Приказ – хIукму. Примета – лишан. Принести – какъий. сакъий, гьакъий.
Принудить – гужбакьий. Принять – кьабулбакьий.
Припой – улкана. Природа – тIабиагIят. Пристально – чикиццул. Причина – багьна.
Продать – бисий. Пропеллер – пяхярбукIан. Просить – тиладибикьий. Проснуться – чисалгьий. Просо – миче.
Просто – либгьи, саматле. Профессия – санигIят.
Прохлада – пяххгIудихь. Прохладный – сярхъинзиб. Прямой – читахьвзиб.
Прятать– бягIнабакьий, вибищий.
Пусто – бацIле. Пустой –бацIзиб. Путать – дишдаххий. Путь – хьхьуне.
Пшеница – ачIе. Пятка – кьгIултIуй. Пятно – ттамгъа.
Пять – хьу.
Раб – лагъ. Работа – гIче.
Работать – викьий. Рабочий – уста.
Радость – ццихъдихь, разидихь.
Радостно – ццихъле, разил.
Радостный – ццихъзиб, разизиб.
Разбить – бахъвий, билкьвий. Разговор – гъай, ихтират.
Раздать – дутIий Раздавать – дуутIий Различный – дикIезиб. Разом – сагьакIле.
Разрешать – ихтиярбилуччий. Рана – дихъя.
Раньше – сибта, талал. Редко – кьанцциб.
Река – акIв. Религия – дин. Ровный – дикьзиб.
Родители – багьанте. Родиться – гьаттакIвий. Розовый – тталаранг.
Ругать – мимивакьий. Ругаться – хIихий.
Ружье – тупанг. Рука – няхъ.
Рыба – бялихъ.
Ряд – тугъ, кьгIукья. Рядом – щулиб.
Сад – бахча. Садиться – киижий.
Сажать – каба̄тий, балхьвий. Санки – гъяр.
Сапоги – хахул чакма. Сарай – дехъв.
Сахар – чакай. Сварить – билщий.
Сверкать – рябцIбукIий. Сверло – йуркка.
Сверху – чилил. Свет – шала.
Светлеть – шалагьаттулхъий. Светлый – шалазиб.
Свеча – шам. Свидетель – бикье. Свинец – ккятун будай. Свистеть – сситукIвий. Свобода – азатдихь.
Связь – бахутте. Сгореть – бикквий. Сделать – баакьий. Сегодня – иял.
Седина – хIиндихь. Седло – жиле.
Сейчас – бусяхIят. Село – ще.
Семья – хъал. Сено – ма.
Сердце – ӯкIве. Серый – хIинзиб. Сестра – йуцце. Сзади – гьилаб. Сидеть – кижий. Сильный – цIакьзив. Сирота – ятим.
Ситец – читI. Сказать – гьаий. Сказка – хабар. Складка – квика.
Скоро – ихьвле. Скорый – бидяхибзиб / гьалакзиб.
Сладкий – мидизиб. Слева – хъямилнащал. След – къил.
Слепой – сукъур. Слово – гъай.
Случай – бухубзиб. Случайно – хабаракквал. Слушать – ляйгувачIий. Слышать – тIамабакьий. Смазать – мутIабакьий. Смех – хIяхIя
Смеяться – хIяхIяукIвий. Смотреть – чивгьий.
Снаружи – тталиб. Сначала – ссибта, багьтал. Снег – дгIухIе.
Снаружи – тталиб. Снизу – гулиб.
Снова – гьибайа, цIил. Собака – хве.
Согласие – кьабулдихь. Сокол – къарччигъа.
Солнце – бейгвала. Соленый – ццумитизиб / ччанкказиб/ччанкка.
Соль – цце.
Сомневаться – ташмишукIвий. Сон – мужил, мужейакквала. Сорт – жура.
Сосед – дене. Сохнуть – бугъвий.
Спать – уссий. Спокойный – паргъатзив. Спорить – ччаливикьий. Способ – тяхIяр.
Способность – гьунар, пагьму. Спрос – бажилъгьаттахъне.
Спросить – хьайбагъий. Спрятать – вибищий.
Спутать – гьябялший. Сражаться – ӯгъий.
Сразу – бусяхIят.
Срочно – гьалакле, хъярхъле. Ссора – ччал.
Сталь – чалдан. Старик – ухъна.
Старый – ухъна /бухъна. Стекло – ккяттяхI. Стена – лас /ласла бяй. Ствол – ккалкка, лула.
Стирать – исий.
Столб – тIал, цциххин.
Стоять – тIашкицций, кицций. Стул – гута.
Суп – нейгъ.
Сушить – бегъвахъий. Счастливый – талихIла. Считать – луги, хIисаббакъий. Съесть – беквий.
Сытый – билкъунзиб. Сюда – яне.
Тайна – бягIнадихь.
Также – налилиттал. Там – иттуб.
Танец – дерхъ. Тарелка – вахъ, хатIа. Таять – бицIий.
Твердый – дибгазиб. Твой – ила.
Темно – цIябгъле. Темнота – цIябгъдихь. Теплый – гьамкIзиб.
Тишина – тIамаакквадихь. Ткань – мас, бейша.
Товар – мас, мятяхI. Толкать – къуртбикьий. Толпа – удаба.
Толстый – бгIуцзиб. Тонкий лист – букIулзиб кIаппе.
Тонкий прут – безиб мурчI. Топор – ба̄тта.
Торопиться – гьалакухвий. Трава – кьай.
Трижды – гIягна. Тропинка – тIгIуйла хьуне. Труд – къӣн, гIяче.
Трудиться – викьий. Трудно – къӣнне.
Трусливый – ухккузив. Туда – итту.
Туман – дӣхьв. Тупой – къутIазиб. Туча – къу.
Тюрьма – туснахъ. Тяжесть – бикIвдихь.
Тяжело – бикIвле/дикIвле. Тяжелый – бикIвзиб.
Убавить – камбакьий. Убить – кахьвий.
Уважение – хIурмат, хъатир. Увеличить – гьисбакьий.
Увидеть – тебидижий, бахкквий.
Ударить – бейхий. Удивиться – ӯкIухъий. Узкий – бугьитзиб.
Узор – някьиш. Уйти – виваший. Украсть – бгIиий. Уксус – кьанцIе.
Улица – кьакьа, хьуне. Умереть – вибчIий.
Уметь, суметь – вихвий/ухвий. Умный – гIякьлуллазив.
Унести – дукъий. Упасть – кичий.
Упрямый – ччалухъ, нягIя. Урок – дарас.
Уронить – кабкахъий. Усы – супил.
Успех – чиухъне. Усталый – вамццузив. Устать – вамцций.
Утка – бятI-бятIе.
Утро – ччавалла, ццугай. Утром – ччавалла.
Ухо – ляй.
Учеба – билчIутте. Ученый – гIялим. Учить – бахий.
Ущерб – зарал.
Фартук – партукI. Фарфор – ккачI. Фасоль – хъаа.
Фигура – куц, къалип. Финик – чамисттак.
Фиолетовый – манавша. Флаг – байрахъ.
Фурункул – ццумагу.
Халва – хIялава, матIухь. хватать – хъямагъи, ххапбакьи. Хвост – кIуме.
Хитрый – гIямултар. Хищник – къарччигъа. Хлеб – тIулутI(кквейкква, кIаппе, кьвачIа, сулкъа). Хлопать – хъват чидехий. Хлопок – бамба.
Хмельной – киплазив. Ходить – ваший.
Хозяин – вагь, хужаим. Холод – буххедихь.
Холодный – буххезиб. Хороший – гIяхзиб.
Хорошо – гIяхле
Хотеть – биччихъий. Храбрость – гъвабзадихь. Хромать – лянкIукIвий, ЖгIуркьукIий.
Худой – назиксив.
Цапля – кьанкь. Царь – пача, паччяхI. Цвет – ранг.
Цветок – уггве, вава. Целиком – либ-либилал, саннибле.
Целый – саннибзиб, битунне. Цель – мурад, кьаст.
Цена – багьа, кьимат, хIякь. Ценный – эбзиб, дурхъазиб. Цепь – йахас.
Цепочка – бимхха. Цинк – тутия.
Чабан – дукруш. Час – сяхIят.
Часть – бутIа, пай. Человек – инсан. Черемша – хIянку. Черный – ццуттезиб. Черт – шейтIан, иблис. Чинить – балчебакьий, гIяхбакьий.
Число – лугге.
Чистить – абдубакьий. Чистый – абдузиб.
Чтение – калучIне. Что – се.
Чудо – тамаша. Чужбина – ӯла улкка. Чуть – бара.
Чуть-чуть – бара-бара.
Шабер – игъвла. Шаг – кканц.
Шагать – ваший, кканцкабицций. Шалаш – къуш, чатир. Шапка – кьапIа.
Шелк – дараэ. Шерсть – ппала. Шиповник – гасе. Шило – дуп.
Ширина – ӯкьатдихь. Широкий – бугьитIзиб. Шить – ба̄хий.
Шкура – кабц, куле. Штраф – хIякIа, иштарап. Штихель – дуп.
Щебень – гъягъяй. Щедрость – сахаватдихь. Щедрый – сахаватзив.
Щека – эйкъкъе.
Щель – тIякь.
Этаж – дях. Это – ил.
Ювелир – муте-асла уста. Юла – кказ-кказе.
Юмор – масхъара. Юность – жагьилдихь. Юркий – сеххузив.
Юродивый – абдал, авлия.
Ябеда – гIярзаче, гIярзукь. Яхонт (рубин) – якьут.
Янтарь – юсру. Яблоко – гьинзе. Явно – ашкарле. Ягненок – мукьаре. Яд – загьру, агъру.
Яичница – хайгана.
Яйцо – духъе. Ясный – абдибзиб. Ястреб – къиргъу. Ячмень – мухъе.
Ящик – ящикI, тIакьа.